  #######################################
      # #     # #   #     #   #     #   #
# # # # # ##### # ### ##### ### ##### # #
# # #     #       # #   #   # # #     # #
### ### ### ####### # # ### # # # ### ###
#   # #   # #         #     # #     # # #
### # # ### ### ############# # ##### # #
#     #     # #   #         # #   # # # #
# # ##### ### ### # ### # ### # ### ### #
# #   #   #   # # #   # #   #         # #
# # ##### # ### # # ####### ##### ##### #
# # # #   # # # #     # #         #     #
# # # ### # # # # ##### ### ##### ##### #
# # #       #     #       #     #       #
# ### # ########### ### ### ######### ###
# # # #       #   #   #   # #     #   # #
# # ##### ##### ##### # # # ##### # ### #
# #   # # # #     #   # #   #   #     # #
# # ### # # ### # # ########### # ### # #
#   # # #     # #       # # #   # #     #
## ## # ### ##### ####### # # ### ### ###
#   #   #   #   #   # #   #         #   #
# ### ##### ### ### # # # ##### # # #####
#     #       #   #   # #   #   # #     #
# ##### ####### # ##### ######### ##### #
#         #   # #   #   #     #       # #
######### # ####### # # # # # ### ### ###
# # #       #   # #   # # # #       #   #
# # ##### # # ### ##### ### # # ####### #
#       # #         #       # #     #   #
# # # # # ### ### # ### ### # # ### # # #
# # # # #   #   # # #     # # # #   # # #
##### ############# ### ### ####### ### #
#     #     #           # # #   #     # #
# ### ##### ########### # ### # ### #####
# #   #     #     #         # #   # #   #
# # ##### ### ##### ##### ### # ### # ###
# #   #     #   # #   # #     # # #     #
# ##### ##### ### # ### ####### # ##### #
#                     #           #      
#######################################  
